11111111
10000C01
1E011P11
10000001
11111111