11111111
10000C01
10011P11
1E0000C1
11111111