11111111
10000C01
10011P11
100E00C1
11111111