11111111
1000E011
110E0011
11111111