111111
10x$x1
1EkCP1
121\n1
111111